11111111111
10000C00001
10110101101
10110101101
1C1100011C1
11111011111
10000P00001
10101010101
10101010101
10C01010101
111110C0101
11111111101
11111111101
1E000000001
11111111111