1111111111
1000000001
1P1C11C1E1
1000000001
1111111111