1111111
1001001
1P01CE1
1001001
1111111