111111111111
1P0000010001
101111010101
100000000101
111101110101
1C0001C001E1
111111111111